D,D,D,D,M,G,G,G
D,M,D,M,F,F,G,G
D,D,M,M,F,G,M,F
D,D,M,F,F,G,F,F
G,D,M,F,G,G,G,G
G,G,D,M,F,G,M,G
D,M,G,F,F,G,G,G
G,G,G,G,G,G,G,G